###################
#B       b       B#
#                 #
#                 #
#    b       b    #
#   bBb  b  bBb   #
#    b       b    #
#                 #
#                 #
#b   b   B   b   b#
#                 #
#                 #
#    b       b    #
#   bBb  b  bBb   #
#    b       b    #
#                 #
#                 #
#B       b       B#
###################

