###################
#........#........#
#.................#
#.................#
#.................#
#....##.....##....#
#....#.......#....#
#.................#
#.................#
##...............##
#.................#
#.................#
#....#.......#....#
#....##.....##....#
#.................#
#.................#
#.................#
#........#........#
###################
