###################
#Bgg   gbBbg   ggB#
#ggg    gbg    ggg#
#gggg   ggg   gggg#
#  ggb   g   bgg  #
#   bBb  b  bBb   #
#    bgg   ggb    #
#g    ggg ggg    g#
#bgg   gg gg   ggb#
#Bbggb   B   bggbB#
#bgg   gg gg   ggb#
#g    ggg ggg    g#
#    bgg   ggb    #
#   bBb  b  bBb   #
#  ggb   g   bgg  #
#gggg   ggg   gggg#
#ggg    gbg    ggg#
#Bgg   gbBbg   ggB#
###################
