###################
#~~~~~~bB#Bb~~~~~~#
#~       #       ~#
#~     ggbgg     ~#
#~    gggbggg    ~#
#~   ggg # ggg   ~#
#~  ggg  #  ggg  ~#
#~  gg   #   gg  ~#
#~~~bb~~~~~~~bb~~~#
##~~bb~~~#~~~bb~~##
#~~~bb~~~~~~~bb~~~#
#~  gg   #   gg  ~#
#~  ggg  #  ggg  ~#
#~   ggg # ggg   ~#
#~    gggbggg    ~#
#~     ggbgg     ~#
#~       #       ~#
#~~~~~~bB#Bb~~~~~~#
###################
