###################
##.......b.......##
#.................#
#.................#
#.................#
#....##.....##....#
#....#.......#....#
#.................#
#.................#
#b.......B.......b#
#.................#
#.................#
#....#.......#....#
#....##.....##....#
#.................#
#.................#
#.................#
##.......b.......##
###################
