###################
#        #        #
#                 #
#                 #
#                 #
#    ##     ##    #
#    #       #    #
#                 #
#                 #
##       #       ##
#                 #
#                 #
#    #       #    #
#    ##     ##    #
#                 #
#                 #
#                 #
#        #        #
###################
